1111111111111111111111111111111111
1000000000000000000000000000000001
1000000000000000000000000000000001
1000000000000000000000000000000001
1002222222200000000000000000000001
1002000000200000210000000000000001
1002000000200000210000000000000001
1002000000200000000000000000000001
1002000000200000000000000000000001
1002000000200000000000000000000001
1000000000000000000000000000000001
1000000000000000000000000000000001
1000000000000000000000000000000001
1000000000000000000000000000000001
1000000000000000000000000000000001
1000000000000000000000000000000001
1000000000000000000000000000000001
1000000000000000000000000000000001
1000000000000000000000000000000001
1000000000000000000000000000000001
1000000000000000000000000000000200
1000000000000000000000000000000001
1000000000000000000000000000000001
1111111111111111111111x11111111111